5
20
20
xxxxxxxxxxxxxxxxxxxx
xS........x.....x..x
xxxxxxxxx.xxx.x.x.xx
x.T...x.....T.x.T..x
x.x.x.xxxxxxxxx.x.xx
x...x.........x.x..x
x.xOxxxxx.x.x.xxx.xx
x.x.x...x.x.x...x..x
xxx.x.xxx.xxxxx.xTxx
x.T.x.....xE....x..x
x.xxx.xxx.xxxxxxx.xx
x...x.x.x...x.x...Ox
x.x.xxx.x.xxx.xxx.xx
x.x.....x.x.....x..x
x.x.xxx.xxxOxxxTx.xx
x.x.x.x.T.x.O.x.T.Tx
xxx.x.xxx.xxx.xxx.xx
x.......x.......O..x
xTx.x.x.x.xOx.x.x.xx
xxxxxxxxxxxxxxxxxxxx
