5
20
20
xxxxxxxxxxxxxxxxxxxx
xS............x....x
xxxxxxxxxxx.xxxxx.xx
x.T.......x.....x..x
x.x.xxxxx.xxxxx.x.xx
x.x.x...x.....x....x
xxx.x.x.x.xxx.xTx.xx
x.T.x.x.x.x.x...x.xx
x.xxxxxTxxx.xxxxxxxx
x.x.......O........x
x.xxxxxxx.xxxOxxx.xx
x...x.......x.x...Tx
xOxxxOxxx.xxx.x.xxxx
x.x.x.x...x.x.x....x
x.x.x.x.xxx.x.xTx.xx
x.x...x.....T.x.x..x
x.x.xxxxx.xxxxx.x.xx
x...x.....xE..T.O.Tx
x.x.x.x.x.xxxOx.x.xx
xxxxxxxxxxxxxxxxxxxx
