5
20
20
xxxxxxxxxxxxxxxxxxxx
xSx...xE......x....x
x.x.x.xxx.x.xxx.x.xx
x.O.x...x.x.x...x..x
xxxxx.x.xxx.xxx.x.xx
x...x.x...x.....x..x
x.xxxxxxx.x.xxxxx.xx
x.......x.x.x...O..x
x.x.xxxxx.x.x.xxx.xx
x.x.x.x...x.x...x..x
xxx.x.xxx.x.x.xOx.xx
x...x.x...x.x.x.x..x
xTx.x.x.xxxxxxx.x.xx
x.T...x.x.O.....x.xx
xOxxxxx.xxxxxTxxxxxx
x...T.x.....x...x..x
x.xxx.x.xxx.x.xxx.xx
x...x.....x........x
x.x.xTx.xxx.x.x.xOxx
xxxxxxxxxxxxxxxxxxxx
