5
20
20
xxxxxxxxxxxxxxxxxxxx
xSx.......x.x.T...xx
x.xxxTxxx.x.x.xTxxxx
x...x...x...x.x....x
xxx.x.x.x.x.x.xxx.xx
x.x...x...x...x....x
x.xxxxxxxxxxxxx.xxxx
x.x.O.....x.....O..x
xOx.xxxOx.x.xxxxx.xx
x...x...O.x.x.O....x
xTx.x.xxx.x.x.x.x.xx
x.x.x...x.x.x...x..x
x.xxxxx.xxx.xxx.xTxx
x.x...x.x.......x.Ox
xOx.x.x.xxxxxxxxx.xx
x...x.x.T.......x..x
x.x.x.x.x.xxxxx.x.xx
x.x.xEx.x...x...O..x
x.xxx.xxxTx.xxx.x.xx
xxxxxxxxxxxxxxxxxxxx
