5
20
20
xxxxxxxxxxxxxxxxxxxx
xS..x.......x......x
xxx.xxxxx.x.xxx.x.xx
x.x.x.....x.x...x..x
x.x.xTxxx.x.x.xxx.xx
x...x...x.x.x.x....x
x.xxxxx.xxx.x.x.xxxx
x.x.......x...x...xx
x.xxxOxxxxxxx.x.xxxx
x...x.x...x.x.x.x..x
xxx.x.x.xxx.xxx.x.xx
x...x.x.T.......x..x
xxx.xTx.x.xxxxxxx.xx
x.x...x.x.x........x
x.x.xxx.x.x.xxx.x.xx
x.x.x...x.xEx.x.x..x
x.xxx.x.x.xxx.x.xTxx
x...O.x.........x..x
xTx.x.x.x.x.x.x.x.xx
xxxxxxxxxxxxxxxxxxxx
