5
20
20
xxxxxxxxxxxxxxxxxxxx
xS..xEx.T.T........x
xxx.x.x.xxx.x.xxx.xx
x...x...x.T.x.x.x..x
x.xxxxxxx.x.x.x.xxxx
x.x.......x.x.x.T..x
x.xxx.xxxxxxxxx.xOxx
x...x...x.x.x...x..x
xTxxx.xxx.x.x.xxx.xx
x.x...x.......x.x..x
x.x.xxx.xxxxxxx.xOxx
x.x...T.......x...Tx
x.xxxxxxxxxxxxx.x.xx
x.x.....x.......x..x
x.x.xxx.x.xxxxxxx.xx
x.....x...x........x
xxxxxxx.x.x.x.xxxxxx
x.......x.x.x......x
x.x.x.x.xxxxx.x.x.xx
xxxxxxxxxxxxxxxxxxxx
