5
20
20
xxxxxxxxxxxxxxxxxxxx
xSx.......x.T......x
xTx.xxx.xxx.x.x.xOxx
x.O.x.x.x...x.x.O..x
xxxxx.x.xxxxx.xxx.xx
x.x.x...x.....x....x
x.x.x.xxx.xxx.x.xxxx
x.x...x.....x.x....x
x.x.xxxxxxx.xxxxx.xx
x.x.x.....x...x....x
x.x.x.x.xxx.xOxxx.xx
x.....x.x.x.x.x....x
xOxxxxx.x.xxx.x.xxxx
x...O.T.x.x.x.x...Tx
x.xxxxxxx.x.x.xxx.xx
x...x.O.......x....x
xxx.xxxOxxxxxxx.xOxx
x.......xE....T.O..x
xOx.x.x.x.x.xOx.x.xx
xxxxxxxxxxxxxxxxxxxx
