5
20
20
xxxxxxxxxxxxxxxxxxxx
xSx.........x.T..E.x
x.xxx.xxxTx.xxx.xxxx
x...x.x.x.x...x....x
xxxTxxx.x.x.xxxOx.xx
x.x.T...x.x...x....x
x.xxxxx.xOxxx.x.x.xx
x.......x...x.T.x..x
x.xxxxxxx.xxxxxxx.xx
x.T.x...O.T...T.x..x
x.x.xTxxxxxxxxx.xxxx
x.x.x.x.x.x.....x.xx
xxx.x.x.x.xxx.x.x.xx
x.x.x.O...x...x.x..x
xTx.xxxxx.x.xxx.x.xx
x.......x.x...x....x
x.xxx.x.xxxxx.xxxOxx
x...x.x.........x..x
x.xOxxx.x.x.x.xxx.xx
xxxxxxxxxxxxxxxxxxxx
