5
20
20
xxxxxxxxxxxxxxxxxxxx
xSx.x.x.....x.T...Ox
x.x.x.xxx.xOx.x.x.xx
x.x...x.x.x...x.x.Tx
x.x.x.x.x.xxxxx.xxxx
x...x.x...x.......xx
xxxxx.xxxxxTxxx.xxxx
x..Ex...x...x...x..x
x.xxxxx.x.xxx.xxx.xx
x.....x.....x.x.x..x
x.xxx.xxxxxxx.x.xOxx
x.x.x.....x.x......x
xxx.x.x.xxx.xxxxxTxx
x.....x.x...x......x
x.x.xxxxxOx.x.xxxxxx
x.x.x.....x.x...T..x
x.xxx.xxxOxTxxx.x.xx
x.......x.x.T.....Tx
x.x.x.xxx.x.x.x.x.xx
xxxxxxxxxxxxxxxxxxxx
